4 13 31
###############################
#p ***1      ***   1         b#
# #*#*#*#*#*#*#*#*#*#*#*#*#*#*#
#    * * *** **     * 5   **  #
# #*# # # # #1# #f#1# # # # #*#
#     4    *     ** 4    *  **#
# # #*# # # # # #*#*#*#*# # # #
#   *        *5  * *5* *      #
# # # # #*# # # # # # #*# #*# #
#   ****    1    *1 *    3    #
# #s# # # # # # # #*#6#6# x #*#
#  ** * 5 *    2    *        2#
###############################