3 13 31
###############################
#p * *2       *  ** * *      *#
# # # # #*# # #*# # # # # #*# #
#    * * *** **      *    **  #
#f#*# # # # #1# #b#1# # # # #*#
#     4    *     ** 4    *  **#
# # #*# # # # # #*#*#*#*# # # #
#   *        *4  * * * *      #
# # # # #*# #s# # # # #*# #*# #
#   ****         *1     *3   *#
# # # # # # # # # #*# # # x #*#
#  ** *   *    2        *    *#
###############################