2 13 31
###############################
#p * *2       *  ** * *      *#
# # # # #*# # #*# # # # # #*# #
#    * * *** **      *    **  #
# #*# # # # #1# #b#1# # # # #*#
#     3    *     ** 3    *  **#
# # #*# # # # # #*#*#*#*# # # #
#   *        *3  * *x* *      #
# #f# # #*# # # # # # #*# #*# #
#   ****         *1           #
# # # # # # # # # #*# # # # #*#
#  ** *   *    2              #
###############################